count;area;electorate;valid_votes;remain;leave;pct_crimes;pct_voted;pct_remain;pct_leave
362544;Birmingham;707293;450702;223451;227251;0,5125796522798897;0,6372210667997562;0,4957843541852488;0,5042156458147512
329640;Leeds;543033;387337;194863;192474;0,6070349315787439;0,7132844596921366;0,5030838778634625;0,4969161221365374
111417;Cornwall;419755;323205;140540;182665;0,26543340758299483;0,7699848721277889;0,4348323819247846;0,5651676180752154
234960;Sheffield;396406;266753;130735;136018;0,5927256398742703;0,6729287649531036;0,49009758090818095;0,509902419091819
174106;County Durham;389507;267398;113521;153877;0,4469906830942704;0,6865037085341213;0,42453945055684783;0,5754605494431522
100939;Wiltshire;366555;288895;137258;151637;0,27537204512283286;0,7881354776227305;0,47511379566970696;0,524886204330293
237618;Bradford;342817;228488;104575;123913;0,6931336543987026;0,6665013695353498;0,45768267917789995;0,5423173208221
329886;Manchester;338064;201814;121823;79991;0,9758093142126935;0,5969698045340527;0,6036399853330294;0,3963600146669706
216437;Liverpool;317924;203554;118453;85101;0,680782199519382;0,6402599363369862;0,5819242068443754;0,41807579315562454
183605;Bristol, City of;312465;228445;141027;87418;0,5876018114028771;0,7311058838589922;0,6173345881940948;0,38266541180590513
146398;Kirklees;307081;217240;98485;118755;0,4767406645152256;0,7074354974746077;0,4533465291843123;0,5466534708156877
90094;Cheshire East;285957;221125;107962;113163;0,31506135537860586;0,773280598131887;0,48823968343697005;0,51176031656303
63397;East Riding of Yorkshire;266047;198915;78779;120136;0,23829248215540863;0,7476686450138509;0,3960435361837971;0,6039564638162029
89620;Cheshire West and Chester;259878;193537;95455;98082;0,34485412385811803;0,7447225236457107;0,49321318404232783;0,5067868159576722
127669;Wakefield;246096;175042;58877;116165;0,5187772251479098;0,7112752746895521;0,33635927377429414;0,6636407262257058
111619;Croydon;245349;171134;92913;78221;0,4549396981442761;0,6975125229774729;0,5429254268584852;0,45707457314151484
76072;Dudley;244516;175226;56780;118446;0,31111256523090514;0,7166238610152301;0,3240386700603792;0,6759613299396209
144014;Cardiff;243689;169604;101788;67816;0,5909745618390654;0,6959854568733098;0,6001509398363246;0,3998490601636754
92834;Wirral;242568;172000;88931;83069;0,38271330101249956;0,7090795158471027;0,5170406976744186;0,4829593023255814
97406;Northumberland;240496;178721;82022;96699;0,40502128933537357;0,7431350209566895;0,45893879286709455;0,5410612071329055
74430;Shropshire;236788;183153;78987;104166;0,31433180735510247;0,7734893660151697;0,4312623871844851;0,5687376128155149
110105;Wigan;235982;163273;58942;104331;0,4665821969472248;0,6918875168445051;0,36100273774598374;0,6389972622540163
80832;Bromley;231473;182432;92398;90034;0,3492070349457604;0,7881351172706968;0,5064791264690405;0,49352087353095947
98844;Barnet;223467;161033;100210;60823;0,44232034260092096;0,7206119919272197;0,6222948091384995;0,37770519086150045
92601;Sandwell;221429;147254;49004;98250;0,4181972551020869;0,6650167773868825;0,33278552704850123;0,6672144729514987
92836;Coventry;221389;153064;67967;85097;0,4193342939351097;0,691380330549395;0,444043014686667;0,5559569853133329
93588;Stockport;221162;163489;85559;77930;0,42316491983252097;0,7392273537045243;0,5233318449559298;0,47666815504407023
90449;Wandsworth;219521;157884;118463;39421;0,41202891750675336;0,7192204846005621;0,7503166882014644;0,24968331179853565
139474;Doncaster;217432;151182;46922;104260;0,6414603186283527;0,6953070385223886;0,3103676363588258;0,6896323636411742
133334;Leicester;213819;138972;70980;67992;0,6235834981923963;0,6499515945729799;0,5107503669803989;0,48924963301960106
109293;Ealing;212991;149041;90024;59017;0,5131343577897658;0,6997525717049077;0,6040217121463222;0,39597828785367783
132567;Lambeth;210800;141924;111584;30340;0,6288757115749526;0,6732637571157495;0,7862236126377498;0,21377638736225021
55896;South Gloucestershire;207793;158333;74928;83405;0,2689984744433162;0,7619746574716184;0,4732304699588841;0,5267695300411159
117799;Sunderland;207221;134324;51930;82394;0,5684703770370764;0,6482161556985054;0,38660254310473186;0,6133974568952681
80639;Sefton;206298;147878;76702;71176;0,390885999864274;0,7168174194611678;0,5186843208590866;0,48131567914091344
67760;Central Bedfordshire;204004;158804;69670;89134;0,3321503499931374;0,7784357169467265;0,4387169088939825;0,5612830911060175
95150;Enfield;198387;136906;76425;60481;0,4796181201389204;0,6900956211848559;0,5582297342702293;0,4417702657297708
106501;Brighton and Hove;198293;146675;100648;46027;0,5370890550851518;0,7396882391208969;0,6861973751491393;0,31380262485086075
101690;Rotherham;197623;137387;44115;93272;0,5145656123022118;0,6951974213527777;0,32110024965972034;0,6788997503402796
92294;Lewisham;197514;124473;86955;37518;0,4672782688822058;0,6301983656854704;0,698585235352245;0,30141476464775496
115504;Bolton;197109;138080;57589;80491;0,5859904925701008;0,7005261048455423;0,41706981460023174;0,5829301853997683
122519;Southwark;195875;129502;94293;35209;0,6254958519463943;0,6611461391193363;0,7281200290343006;0,2718799709656994
157730;Nottingham;195394;120661;59318;61343;0,8072407545779298;0,6175266384842932;0,49160872195655597;0,5083912780434441
79442;Walsall;194729;135579;43572;92007;0,4079618341387261;0,69624452444166;0,32137720443431506;0,6786227955656849
102416;Hillingdon;193033;133022;58040;74982;0,5305621318634638;0,6891153326115224;0,43631880440829335;0,5636811955917066
103378;Medway;192524;138886;49889;88997;0,5369616255635661;0,7213957740333673;0,3592082715320479;0,6407917284679522
167806;Newcastle upon Tyne;190735;129003;65405;63598;0,8797860906493302;0,6763467638346397;0,5070037130919436;0,4929962869080564
82552;Redbridge;189843;128233;69213;59020;0,4348435285999484;0,6754686767486818;0,5397440596414339;0,46025594035856604
87103;Plymouth;186989;133455;53458;79997;0,4658188449587944;0,7137050842562932;0,4005694803491814;0,5994305196508186
110271;Brent;186793;121404;72523;48881;0,5903379676968623;0,6499387021997612;0,5973691146914435;0,40263088530855656
66434;Havering;183082;139086;42201;96885;0,36286472728067204;0,7596923782785856;0,30341659117380615;0,6965834088261939
122287;Kingston upon Hull, City of;180230;113355;36709;76646;0,6785052433002274;0,6289463463352383;0,32384103039124873;0,6761589696087512
117350;Stoke-on-Trent;179010;117590;36027;81563;0,6555499692754595;0,6568906764985196;0,30637809337528704;0,693621906624713
70642;Milton Keynes;177211;130456;63393;67063;0,3986321390884313;0,7361619764010134;0,48593395474336176;0,5140660452566382
123042;Newham;176985;104699;55328;49371;0,6952114585981863;0,5915699070542701;0,52844821822558;0,47155178177442003
90846;Barnsley;175809;122909;38951;83958;0,5167312253638893;0,6991052790243958;0,31690925806897785;0,6830907419310221
75780;Wolverhampton;174760;117936;44138;73798;0,4336232547493706;0,674845502403296;0,37425383258716594;0,6257461674128341
96394;Salford;173668;109815;47430;62385;0,5550475620148789;0,632327199023424;0,4319082092610299;0,5680917907389701
74008;Swansea;172941;120243;58307;61936;0,42793785163726356;0,6952833625340434;0,48490972447460556;0,5150902755253944
66816;Rhondda Cynon Taf;172890;116563;53973;62590;0,3864653826132223;0,6742032506217827;0,4630371558727898;0,5369628441272102
105394;Derby;171246;120655;51612;69043;0,6154537916214101;0,7045712016631045;0,4277651154117111;0,572234884588289
54174;Bexley;170779;128489;47603;80886;0,31721698803717086;0,7523700220753137;0,37048307637229644;0,6295169236277035
88486;Greenwich;168967;117365;65248;52117;0,5236880574313327;0,6946030881769814;0,5559408682315852;0,44405913176841477
91353;Tameside;168047;110947;43118;67829;0,54361577415842;0,6602141067677495;0,388636015394738;0,611363984605262
132355;Tower Hamlets;167820;108235;73011;35224;0,7886723870813968;0,64494696698844;0,6745599852173512;0,3254400147826489
63103;Trafford;165294;125311;72293;53018;0,3817621934250487;0,7581097922489625;0,5769086512756263;0,42309134872437376
89969;Hounslow;165050;115076;58755;56321;0,5451014843986671;0,6972190245380188;0,5105756195905314;0,4894243804094685
110462;Hackney;163284;106266;83398;22868;0,6765022904877391;0,6508047328580877;0,7848041706660644;0,2151958293339356
85301;Waltham Forest;162983;108551;64156;44395;0,5233736033819478;0,6660265181031151;0,5910217317205737;0,40897826827942624
53879;Harrow;162397;117225;64042;53183;0,33177337019772535;0,7218421522565072;0,5463169119215184;0,45368308807848157
48763;North Somerset;160860;124548;59572;64976;0,30313937585478057;0,7742633345766505;0,4783055528792112;0,5216944471207887
52405;Solihull;160425;121950;53466;68484;0,3266635499454574;0,7601683029453016;0,43842558425584255;0,5615744157441575
116518;Southampton;158171;107665;49738;57927;0,7366584266395231;0,6806873573537501;0,46196999953559653;0,5380300004644035
102476;Oldham;158084;107403;42034;65369;0,6482376458085575;0,679404620328433;0,39136709402903086;0,6086329059709692
59439;Warrington;157042;115144;52657;62487;0,3784911042905719;0,7332051298378778;0,45731431946084905;0,542685680539151
74857;North Tyneside;156993;113462;52873;60589;0,4768174377201531;0,7227201212792927;0,4659974264511466;0,5340025735488534
93742;Rochdale;156621;103231;41217;62014;0,5985276559337509;0,6591134011403323;0,3992695992482878;0,6007304007517121
61743;York;155157;109600;63617;45983;0,39793886192695144;0,7063812783180907;0,5804470802919708;0,4195529197080292
108615;Haringey;150098;105846;79991;25855;0,7236272302095964;0,7051792828685259;0,7557300228634053;0,24426997713659468
76412;Calderdale;149195;105925;46950;58975;0,5121619357217065;0,7099768759006669;0,44323814019353314;0,5567618598064669
75731;Swindon;148960;112965;51220;61745;0,5083982277121375;0,7583579484425349;0,4534147744876732;0,5465852255123268
79441;Gateshead;145866;102958;44429;58529;0,5446162916649527;0,7058396062139224;0,43152547640785566;0,5684745235921443
132939;Camden;145425;95133;71295;23838;0,9141413099535843;0,6541722537390408;0,7494244899246318;0,25057551007536816
99255;Northampton;144948;105259;43805;61454;0,6847628114910175;0,7261845627397412;0,41616393847556976;0,5838360615244302
107464;Islington;144514;101600;76420;25180;0,7436234551669735;0,7030460716608772;0,7521653543307086;0,24783464566929134
66006;Bury;141600;101028;46354;54674;0,46614406779661016;0,7134745762711865;0,4588232965118581;0,541176703488142
84359;Stockton-on-Tees;141486;100415;38433;61982;0,5962356699602788;0,7097168624457544;0,3827416222675895;0,6172583777324105
37400;New Forest;141061;111740;47199;64541;0,26513352379467037;0,7921395708239698;0,42240021478432077;0,5775997852156792
97231;Portsmouth;140517;98720;41384;57336;0,6919518634755937;0,7025484460954903;0,4192058346839546;0,5807941653160453
42553;Sutton;140288;106560;49319;57241;0,30332601505474455;0,7595802919708029;0,46282845345345347;0,5371715465465465
46677;Carmarthenshire;139227;103035;47654;55381;0,3352582473227176;0,740050421254498;0,4625030329499685;0,5374969670500316
49628;Herefordshire, County of;138247;108270;44148;64122;0,35898066504155607;0,783163468285026;0,4077583818232197;0,5922416181767802
41562;Bath and North East Somerset;136522;105230;60878;44352;0,30443445012525455;0,7707915207805336;0,578523234818968;0,421476765181032
50153;Merton;136352;100100;63003;37097;0,36782005397793943;0,7341293123679887;0,6294005994005994;0,3705994005994006
33032;Aylesbury Vale;136235;106833;52877;53956;0,2424633904650053;0,7841817447792417;0,4949500622466841;0,505049937753316
61641;St, Helens;136096;93679;39322;54357;0,452922936750529;0,6883302962614625;0,41975255927155497;0,580247440728445
41494;Charnwood;133780;94172;43500;50672;0,3101659440873075;0,703931828374944;0,4619207407722041;0,538079259227796
67194;Basildon;132771;97999;30748;67251;0,5060894321802201;0,7381054597766078;0,31375830365615975;0,6862416963438402
83148;Bournemouth;132752;91926;41473;50453;0,6263408460889478;0,6924641436663854;0,45115636490220395;0,5488436350977961
46390;Richmond upon Thames;132632;108806;75396;33410;0,34976476265154716;0,8203600940949394;0,6929397275885522;0,3070602724114479
50707;Caerphilly;130801;92473;39178;53295;0,38766523191718716;0,7069747173186749;0,42366961167043354;0,5763303883295665
48882;Chelmsford;129971;100794;47545;53249;0,3760992836863608;0,7755114602488248;0,4717046649602159;0,5282953350397841
69769;Southend-on-Sea;128856;93870;39348;54522;0,5414493698392003;0,7284876140808344;0,41917545541706613;0,5808245445829339
45675;Basingstoke and Deane;128677;100328;48257;52071;0,35495853959915136;0,7796886778522968;0,4809923451080456;0,5190076548919544
37629;Huntingdonshire;128486;99927;45729;54198;0,29286459225129585;0,7777267562224678;0,45762406556786456;0,5423759344321355
79324;Luton;127612;84481;36708;47773;0,6216029840453876;0,662014544086763;0,43451190208449236;0,5654880979155076
58782;Colchester;127520;95719;44414;51305;0,4609629861982434;0,7506195106649938;0,4640040117427052;0,5359959882572948
33813;South Somerset;126495;99467;42527;56940;0,2673070081821416;0,7863314755523934;0,4275488352921069;0,572451164707893
32040;Wycombe;125260;94790;49261;45529;0,25578796104103463;0,7567459683857576;0,5196856208460808;0,48031437915391917
66433;Telford and Wrekin;124338;89603;32954;56649;0,5342936190062572;0,7206405121523589;0,367777864580427;0,632222135419573
47846;North Lincolnshire;123611;88862;29947;58915;0,3870691119722355;0,7188842416937004;0,3370056942225023;0,6629943057774977
20663;Wokingham;121891;97501;55272;42229;0,16952030912864774;0,7999031921963066;0,5668864934718618;0,4331135065281382
23278;Wealden;121141;96892;44084;52808;0,19215624767832526;0,7998282992545876;0,45498080336869917;0,5450191966313008
84343;Peterborough;120892;87392;34176;53216;0,6976723025510373;0,7228931608377726;0,39106554375686564;0,6089344562431344
211034;Westminster;120524;78196;53928;24268;1,7509707610102552;0,6488002389565564;0,6896516445854007;0,3103483554145992
36166;Harrogate;119987;94585;48211;46374;0,30141598673189596;0,7882937318209473;0,5097108420996986;0,4902891579003013
55001;Bedford;119530;86066;41497;44569;0,4601438969296411;0,7200368108424663;0,4821532312411405;0,5178467687588595
48005;Maidstone;117298;89127;36762;52365;0,4092567648212246;0,7598339272621869;0,4124676024100441;0,5875323975899559
39426;Arun;117138;91129;34193;56936;0,33657737028120677;0,7779627447967354;0,3752153540585324;0,6247846459414675
28313;West Berkshire;116757;93277;48300;44977;0,2424950966537338;0,7988985671094667;0,5178125368526003;0,4821874631473997
63952;North East Lincolnshire;116302;78982;23797;55185;0,5498787639077574;0,6791112792557308;0,30129649793623864;0,6987035020637614
36121;Flintshire;115964;86797;37867;48930;0,3114845986685523;0,7484822876064986;0,43627083885387746;0,5637291611461226
58750;South Tyneside;115893;79079;30014;49065;0,5069331193428421;0,6823449216087253;0,3795445061267846;0,6204554938732154
66757;Barking and Dagenham;115812;73880;27750;46130;0,5764255862950298;0,6379304389873243;0,37560909583107743;0,6243909041689226
79179;Hammersmith and Fulham;114863;80242;56188;24054;0,6893342503678295;0,6985887535585872;0,700231798808604;0,299768201191396
25340;South Cambridgeshire;114830;93189;56128;37061;0,22067403988504747;0,8115387964817556;0,6023028469025314;0,39769715309746856
33509;King's Lynn and West Norfolk;113884;85080;28587;56493;0,294237996557901;0,7470759720417267;0,3360014104372355;0,6639985895627645
40887;Poole;113421;85448;35741;49707;0,3604887983706721;0,7533701871787412;0,4182777829791218;0,5817222170208782
34441;Braintree;112562;86236;33523;52713;0,3059735967733338;0,766120004975036;0,38873556287397376;0,6112644371260263
21874;East Devon;112527;88783;40743;48040;0,194388902219023;0,7889928639348779;0,458905421082865;0,5410945789171351
46784;Knowsley;111647;70903;34345;36558;0,4190349942228631;0,6350640859136385;0,48439417231993004;0,5156058276800699
49245;Tendring;111167;82657;25210;57447;0,4429821799634784;0,7435389998830588;0,3049953421972731;0,6950046578027269
58348;Thurrock;109897;79916;22151;57765;0,5309335104688936;0,7271900051866748;0,27717853746433757;0,7228214625356625
36639;Isle of Wight;109844;79380;30207;49173;0,3335548596190962;0,7226612286515421;0,3805366591080877;0,6194633408919124
48567;Canterbury;109399;82048;40169;41879;0,4439437289189115;0,7499885739357763;0,48957927067082685;0,5104207293291732
43149;Dacorum;108965;86244;42542;43702;0,3959895379250218;0,7914835038773919;0,49327489448541345;0,5067251055145865
42349;Kingston upon Thames;108838;85270;52533;32737;0,38910123302523014;0,7834579834249067;0,6160783393925179;0,3839216606074821
25277;Mid Sussex;108416;87528;46471;41057;0,2331482438016529;0,8073347107438017;0,5309272461383786;0,46907275386162145
32008;Cherwell;108342;81836;40668;41168;0,29543482675232136;0,7553488028650016;0,49694510973165845;0,5030548902683416
34525;East Lindsey;107009;80128;23515;56613;0,3226364137595903;0,748796830173163;0,2934679512779553;0,7065320487220448
31336;East Hertfordshire;106260;85366;42372;42994;0,29489930359495575;0,8033690946734425;0,4963568633882342;0,5036431366117659
35248;Neath Port Talbot;105766;75652;32651;43001;0,33326399788211714;0,7152771211920655;0,4315946703325755;0,5684053296674245
27379;South Kesteven;105457;82471;33047;49424;0,25962240534056535;0,7820343836824488;0,4007105528003783;0,5992894471996217
65570;Newport;104977;73649;32413;41236;0,6246130104689599;0,7015727254541471;0,4401010197015574;0,5598989802984427
36892;St Albans;104859;86445;54208;32237;0,35182483144031507;0,8243927559866105;0,6270808028226039;0,372919197177396
36231;Bridgend;104492;74345;33723;40622;0,3467346782528806;0,711489874822953;0,453601452686798;0,5463985473132019
23010;Horsham;104270;85088;43785;41303;0,22067708832837826;0,8160352929893545;0,5145849003384732;0,4854150996615269
20123;South Oxfordshire;104231;84110;46245;37865;0,19306156517734646;0,8069576229720524;0,5498157175127809;0,45018428248721915
24169;Teignbridge;103740;82312;37949;44363;0,23297667245035666;0,7934451513398881;0,46103848770531636;0,5389615122946837
35143;Reigate and Banstead;103731;81161;40181;40980;0,33878975426825153;0,782417984980382;0,49507768509505795;0,504922314904942
61913;Redcar and Cleveland;103529;72714;24586;48128;0,5980256739657487;0,7023539298167664;0,3381192067552328;0,6618807932447671
26770;Powys;103270;79469;36762;42707;0,25922339498402247;0,7695264839740487;0,46259547748178537;0,5374045225182147
52663;Reading;103172;74767;43385;31382;0,5104388787655565;0,7246830535416586;0,5802693701766822;0,41973062982331777
40583;Warwick;103099;81618;47976;33642;0,39363136402874904;0,7916468636941193;0,5878115121664339;0,41218848783356615
45080;Torbay;102961;75824;27935;47889;0,43783568535659134;0,7364341838171735;0,3684189702468875;0,6315810297531125
30832;Windsor and Maidenhead;102665;81792;44086;37706;0,3003165635805776;0,7966882579262651;0,5390013693270735;0,46099863067292646
19433;South Norfolk;102395;80358;38817;41541;0,18978465745397724;0,7847844133014308;0,4830508474576271;0,5169491525423728
98185;Blackpool;102354;66927;21781;45146;0,9592688121617132;0,6538777185063602;0,3254441406308366;0,6745558593691634
49327;Swale;102209;75869;28481;47388;0,48260916357659306;0,7422927530843664;0,37539706599533407;0,6246029340046659
37664;Guildford;102209;78613;44155;34458;0,3684998385660754;0,7691397039399661;0,5616755498454454;0,43832445015455457
50901;Lancaster;100567;73041;35732;37309;0,5061401851501984;0,7262919247864608;0,4892046932544735;0,5107953067455265
63522;Blackburn with Darwen;100117;65321;28522;36799;0,6344776611364703;0,652446637434202;0,4366436521180019;0,5633563478819982
38416;Epping Forest;100016;76852;28676;48176;0,3840985442329227;0,7683970564709647;0,37313277468380784;0,6268672253161922
30639;Stafford;99612;77484;34098;43386;0,3075834236838935;0,7778580893868209;0,44006504568685145;0,5599349543131485
30143;North Hertfordshire;99316;77672;42234;35438;0,30350598090942044;0,7820693543839865;0,5437480688021423;0,4562519311978577
16403;Broadland;99254;77737;35469;42268;0,16526286094263204;0,7832127672436375;0,4562692154315191;0,5437307845684809
61714;Thanet;99108;72102;26065;46037;0,6226944343544416;0,7275093837026274;0,3615017613935813;0,6384982386064186
27996;Breckland;98989;73548;26313;47235;0,282819303154896;0,7429916455363728;0,3577663566650351;0,6422336433349649
29652;Elmbridge;98613;77003;45841;31162;0,3006905783213167;0,7808605356291767;0,5953144682674701;0,4046855317325299
48567;Wrexham;98384;70366;28822;41544;0,49364734103106195;0,7152179216132705;0,4096012278657306;0,5903987721342694
21174;Suffolk Coastal;98195;79184;37218;41966;0,21563216049697032;0,8063954376495748;0,47001919579713075;0,5299808042028693
27432;Stratford-on-Avon;98014;79158;38341;40817;0,2798783847205501;0,807619319689024;0,48436039313777507;0,5156396068622249
49997;Oxford;97331;70337;49424;20913;0,5136801224686893;0,7226577349457007;0,7026742681661146;0,29732573183388544
29282;Eastleigh;97280;76074;36172;39902;0,30100740131578946;0,7820106907894737;0,4754843967715645;0,5245156032284355
29746;Amber Valley;96760;73820;29319;44501;0,30742042166184375;0,7629185613890037;0,3971687889460851;0,6028312110539149
63891;Norwich;96091;66366;37326;29040;0,6649009792800574;0,6906578139471959;0,5624265437121417;0,43757345628785826
40072;Havant;95366;70629;26582;44047;0,4201916825703081;0,7406098609567351;0,37636098486457403;0,623639015135426
42847;Halton;95289;65005;27678;37327;0,4496531603857738;0,6821878705831733;0,42578263210522266;0,5742173678947773
31150;Vale of Glamorgan;95011;72309;36681;35628;0,32785677447874456;0,7610592457715423;0,5072812512965191;0,49271874870348087
94024;Middlesbrough;94612;61358;21181;40177;0,9937851435335898;0,6485223861666596;0,3452035594380521;0,654796440561948
26083;Test Valley;94559;75261;36170;39091;0,27583836546494783;0,7959157774511152;0,4805941988546525;0,5194058011453475
31278;Wychavon;94497;76389;32188;44201;0,33099463475030955;0,8083748690434617;0,4213695689169907;0,5786304310830094
16528;Vale of White Horse;94487;76654;43462;33192;0,17492353445447523;0,8112650417517754;0,5669893286716936;0,4330106713283064
73354;Preston;94284;64745;30227;34518;0,7780111153536124;0,6867018794281108;0,46686230596957295;0,5331376940304271
47153;Nuneaton and Bedworth;93978;69831;23736;46095;0,5017450892762135;0,7430568856540892;0,339906345319414;0,660093654680586
29686;Tonbridge and Malling;93019;74021;32792;41229;0,3191391006138531;0,7957621561186424;0,4430094162467408;0,5569905837532592
35602;Newcastle-under-Lyme;92816;68934;25477;43457;0,38357610756766075;0,7426952249612135;0,36958540052804134;0,6304145994719587
22314;Stroud;92631;74064;40446;33618;0,24089127829776208;0,7995595427016874;0,5460952689565781;0,4539047310434219
21523;Waverley;92291;75942;44341;31601;0,23320800511425815;0,8228537993953907;0,5838798030075584;0,4161201969924416
29587;Pembrokeshire;92155;68522;29367;39155;0,3210569149801964;0,7435516249796539;0,42857768307988675;0,5714223169201132
38964;Ashfield;91916;66899;20179;46720;0,42390878628312806;0,727827581705035;0,3016338061854437;0,6983661938145562
24079;Chichester;91659;71337;35011;36326;0,26270197143761115;0,7782869112689424;0,49078318404194177;0,5092168159580582
56432;Ipswich;91574;66353;27698;38655;0,6162447856378448;0,7245833970340927;0,4174340270974937;0,5825659729025063
31540;Conwy;91368;65504;30147;35357;0,34519744330619034;0,7169249627878469;0,46023143624816804;0,5397685637518319
21155;East Hampshire;90588;73922;37346;36576;0,23352982735020092;0,816024197465448;0,5052081924190363;0,4947918075809637
34380;Ashford;90516;69786;28314;41472;0,3798223518493968;0,770979716293252;0,4057260768635543;0,5942739231364457
31929;Waveney;90391;65646;24356;41290;0,3532320695644478;0,7262448695113451;0,3710203211162904;0,6289796788837096
23893;Fareham;90175;71735;32210;39525;0,2649625727751594;0,7955087330191295;0,4490137310936084;0,5509862689063916
31840;Sedgemoor;89714;68414;26545;41869;0,35490558887130214;0,7625788617161201;0,38800537901599086;0,6119946209840091
52874;Gloucester;89661;64577;26801;37776;0,5897101303799869;0,7202351077949164;0,41502392492683154;0,5849760750731685
25696;Winchester;89595;72764;42878;29886;0,28680171884591776;0,8121435347954685;0,5892749161673355;0,4107250838326645
22661;Gedling;88298;67577;30035;37542;0,25664227955333074;0,7653287730186414;0,44445595394882875;0,5555440460511712
46782;Slough;87873;54542;24911;29631;0,5323819603291113;0,6206912248358426;0,4567305929375527;0,5432694070624473
32336;Erewash;87596;66530;25791;40739;0,3691492762226586;0,7595095666468789;0,3876597023898993;0,6123402976101007
31674;Newark and Sherwood;87338;67087;26571;40516;0,36266001053378827;0,7681307105727175;0,3960677925678596;0,6039322074321404
27745;Sevenoaks;87253;70349;32091;38258;0,31798333581653354;0,8062645410472993;0,4561685311802584;0,5438314688197415
41945;Cheltenham;87060;66013;37081;28932;0,48179416494371696;0,7582471858488399;0,561722690985109;0,438277309014891
14818;North Kesteven;86468;67753;25570;42183;0,17136975528519222;0,783561548781052;0,377400262718994;0,622599737281006
41645;Exeter;86417;63803;35270;28533;0,4819074950530567;0,7383153777613201;0,5527953231039293;0,44720467689607074
16626;Rushcliffe;86401;70410;40522;29888;0,192428328375829;0,8149211235981065;0,5755148416418122;0,42448515835818773
26991;West Lancashire;85834;63869;28546;35323;0,31445581005196077;0,7440990749586411;0,4469460927836666;0,5530539072163334
19521;South Staffordshire;85777;66692;23444;43248;0,22757848840598296;0,7775044592373247;0,35152641996041506;0,648473580039585
35512;Bassetlaw;85547;63967;20575;43392;0,4151168363589606;0,7477410078670205;0,3216502258977285;0,6783497741022715
21445;Hinckley and Bosworth;85305;65470;25969;39501;0,251392063771174;0,7674813903053749;0,3966549564686116;0,6033450435313884
19302;Bracknell Forest;85298;64890;29888;35002;0,22628901029332457;0,7607446833454478;0,46059485282786256;0,5394051471721375
23709;Mendip;85068;65455;33427;32028;0,27870644660741994;0,7694432689142804;0,5106867313421435;0,4893132686578565
36039;Dover;85011;65016;24606;40410;0,42393337332815756;0,7647951441578149;0,3784606866002215;0,6215393133997785
29499;Gwynedd;84575;61182;35517;25665;0,3487910138929944;0,7234052616021283;0,5805138766303815;0,4194861233696185
28226;South Ribble;84573;63724;26406;37318;0,33374717699502204;0,7534792427843402;0,41438076705793736;0,5856192329420626
30110;Wyre;84471;62979;22816;40163;0,356453694167229;0,7455694853855169;0,3622794899887264;0,6377205100112736
32037;Taunton Deane;84164;65733;30944;34789;0,38064968395038257;0,781010883513141;0,47075289428445377;0,5292471057155462
30801;Chorley;84159;63515;27417;36098;0,3659858125690657;0,7547024085362231;0,4316618121703535;0,5683381878296465
25503;Broxtowe;83593;65426;29672;35754;0,30508535403682124;0,7826731903389039;0,45352000733653286;0,5464799926634671
31727;East Staffordshire;83558;62116;22850;39266;0,3797003279159386;0,7433878264199718;0,36786013265503253;0,6321398673449675
15281;North Norfolk;83065;63790;26214;37576;0,18396436525612472;0,7679528080418949;0,41094215394262423;0,5890578460573758
74931;Kensington and Chelsea;83042;54739;37601;17138;0,9023265335613304;0,6591724669444378;0,6869142658799028;0,3130857341200972
42617;Scarborough;82900;60511;22999;37512;0,5140772014475271;0,7299276236429433;0,38007965493877144;0,6199203450612285
12976;West Oxfordshire;82441;65671;35236;30435;0,15739741148215086;0,7965817978918257;0,5365534254084756;0,46344657459152444
25356;Tunbridge Wells;82181;64996;35676;29320;0,30853846996264345;0,7908884048624378;0,5488953166348698;0,45110468336513015
19744;West Dorset;82071;65191;31924;33267;0,24057218749619233;0,7943244264112781;0,489699498397018;0,510300501602982
17119;South Lakeland;81948;65331;34531;30800;0,20890076633963;0,797225069556304;0,5285545912354013;0,47144540876459873
29793;Worthing;81384;61366;28851;32515;0,366079327631967;0,7540302762213703;0,47014633510412934;0,5298536648958707
26593;St Edmundsbury;81148;62210;26986;35224;0,3277098634593582;0,7666239463695963;0,43378877993891657;0,5662112200610834
33441;Shepway;80879;60613;22884;37729;0,4134695038267041;0,7494281581127363;0,3775427713526801;0,6224572286473199
20606;Lichfield;80369;63278;26064;37214;0,2563923901006607;0,7873433786659035;0,41189670975694553;0,5881032902430544
34697;Carlisle;80124;59683;23788;35895;0,4330412860066896;0,7448829314562428;0,3985724578188094;0,6014275421811907
52200;Cambridge;80108;57799;42682;15117;0,6516203125780197;0,7215134568332751;0,7384556826242669;0,26154431737573314
33082;Chesterfield;79905;57424;22946;34478;0,41401664476565925;0,7186534009135849;0,39958902201170243;0,6004109779882976
18740;Staffordshire Moorlands;79347;59760;21076;38684;0,23617780130313684;0,7531475670157662;0,3526773761713521;0,6473226238286479
17849;North East Derbyshire;78855;59310;22075;37235;0,2263521653668125;0,7521400038044512;0,37219693137750803;0,627803068622492
15569;Mid Suffolk;78325;61185;27391;33794;0,19877433769549951;0,781168209383977;0,44767508376236004;0,5523249162376399
38643;Welwyn Hatfield;78146;58610;27550;31060;0,4944974790776239;0,7500063982801423;0,47005630438491725;0,5299436956150827
35558;Wyre Forest;77878;57632;21240;36392;0,45658594211458947;0,7400292765607746;0,36854525263742366;0,6314547473625763
45618;Darlington;77662;55166;24172;30994;0,5873915170868635;0,7103345265380753;0,43816843708081066;0,5618315629191893
39859;Mansfield;77624;56344;16417;39927;0,5134880964650108;0,7258579820674018;0,29137086468834306;0,7086291353116569
21330;Lewes;76428;59482;30974;28508;0,27908619877531793;0,7782749777568431;0,5207289600215191;0,47927103997848086
20960;North Devon;75548;58031;24931;33100;0,27743950865674805;0,7681341663578123;0,4296152056659372;0,5703847943340629
29970;Denbighshire;75362;52072;23955;28117;0,39768052864839043;0,6909583079005335;0,4600361038561991;0,5399638961438009
26546;Cannock Chase;75010;53578;16684;36894;0,3538994800693241;0,7142780962538329;0,3113964686998395;0,6886035313001605
22729;Allerdale;74426;54238;22429;31809;0,3053905893101873;0,728750705398651;0,41352925992846346;0,5864707400715365
24735;Bromsgrove;74170;58815;26252;32563;0,33349062963462317;0,7929755966023999;0,4463487205644818;0,5536512794355182
30096;Rugby;74137;58549;25350;33199;0,40595114450274494;0,7897406153472625;0,4329706741361936;0,5670293258638064
39781;Dartford;73951;55855;19985;35870;0,5379372827953645;0,7552974266744196;0,3578014501835109;0,6421985498164892
20506;North West Leicestershire;73944;57611;22642;34969;0,277317970355945;0,7791166288001731;0,39301522278731493;0,6069847772126851
19166;South Derbyshire;73856;56695;22479;34216;0,2595049826689775;0,7676424393414212;0,39648999029896814;0,6035100097010319
19944;Blaby;73832;56471;22888;33583;0,2701267742984072;0,7648580561274244;0,40530537798161886;0,5946946220183811
43714;Crawley;73575;53835;22388;31447;0,5941420319401971;0,7317023445463813;0,4158632859663787;0,5841367140336212
45793;Worcester;73516;54239;25125;29114;0,6228984166712008;0,7377849719788889;0,46322756687992034;0,5367724331200796
19943;West Lindsey;73499;54753;20906;33847;0,27133702499353735;0,7449489108695356;0,38182382700491296;0,618176172995087
30400;Hertsmere;73295;56125;27593;28532;0,4147622620915479;0,7657411828910566;0,4916347438752784;0,5083652561247216
39719;Gravesham;72808;54519;18876;35643;0,5455307109108889;0,7488050763652346;0,3462279205414626;0,6537720794585374
18922;Rother;72755;57669;23916;33753;0,2600783451309188;0,7926465535014776;0,41471154346355926;0,5852884565364407
28283;Spelthorne;72674;56609;22474;34135;0,3891763216556127;0,7789443267193219;0,39700400996308005;0,60299599003692
36708;Great Yarmouth;72634;50128;14284;35844;0,5053831538948702;0,6901451111049921;0,28495052665177145;0,7150494733482285
20062;High Peak;72487;54833;27116;27717;0,27676686854194543;0,7564528812062853;0,4945197235241552;0,5054802764758448
13271;East Dorset;71966;58488;24786;33702;0,1844065253036156;0,8127171164160854;0,4237792367665162;0,5762207632334838
33925;Eastbourne;71726;53545;22845;30700;0,47298050915985834;0,7465214845383822;0,4266504809039126;0,5733495190960874
17997;Monmouthshire;71607;55630;28061;27569;0,25133017721731116;0,7768793553702851;0,5044220744202769;0,4955779255797232
27160;Fenland;71447;52626;15055;37571;0,380141923383767;0,7365739639173093;0,2860753239843423;0,7139246760156577
26674;Woking;71313;55221;31007;24214;0,374041198659431;0,7743468932733162;0,5615073975480342;0,43849260245196575
15139;South Northamptonshire;71309;56624;25853;30771;0,21230139253109706;0,7940652652540352;0,45657318451539985;0,5434268154846001
15925;Babergh;70628;55242;25309;29933;0,22547714787336468;0,7821543863623492;0,45814778610477536;0,5418522138952246
33575;Kettering;70570;53907;21030;32877;0,47576874025789995;0,7638798356242029;0,39011631142523234;0,6098836885747676
50402;Hartlepool;70341;46100;14029;32071;0,7165380077053212;0,6553787975718287;0,3043167028199566;0,6956832971800434
13176;Chiltern;70185;58604;32241;26363;0,1877324214575764;0,8349932321721165;0,5501501603986076;0,4498498396013924
16324;Hambleton;70133;54982;25480;29502;0,23275776025551453;0,7839676044087662;0,4634243934378524;0,5365756065621476
15736;Hart;69946;57795;30282;27513;0,2249735510250765;0,82628027335373;0,5239553594601609;0,4760446405398391
12213;South Hams;69121;55450;29308;26142;0,17669015205219832;0,8022164031191679;0,5285482416591524;0,4714517583408476
31430;Broxbourne;68997;50872;17166;33706;0,4555270519008073;0,737307419163152;0,3374351313099544;0,6625648686900456
31465;Torfaen;68957;48144;19363;28781;0,45629885290833416;0,6981742245167278;0,4021892655367232;0,5978107344632768
20268;Castle Point;68860;51845;14154;37691;0,29433633459192565;0,7529044437990124;0,27300607580287395;0,726993924197126
14750;Cotswold;68734;54821;28015;26806;0,21459539674687927;0,7975819827159776;0,5110267963006877;0,4889732036993123
21192;East Northamptonshire;68334;52574;21680;30894;0,3101238036702081;0,7693681037258173;0,41237113402061853;0,5876288659793815
16107;Tewkesbury;67831;53652;25084;28568;0,2374577995311878;0,7909657826067727;0,4675314992917319;0,5324685007082681
14038;Harborough;67420;54878;27028;27850;0,20821714624740434;0,8139721150993771;0,4925106600094756;0,5074893399905245
18394;Three Rivers;67380;52848;25751;27097;0,272989017512615;0,7843276936776492;0,4872653648198607;0,5127346351801393
17695;Mole Valley;66730;54796;29088;25708;0,2651730855687097;0,821159898096808;0,5308416672749836;0,46915833272501645
15745;Forest of Dean;66705;51643;21392;30251;0,23603927741548608;0,7741998350948205;0,41422845303332495;0,5857715469666751
15214;Rochford;66589;52447;17510;34937;0,22847617474357626;0,7876225803060566;0,33386085000095334;0,6661391499990467
28663;Rushmoor;65790;48780;20384;28396;0,43567411460708316;0,7414500683994528;0,4178761787617876;0,5821238212382124
18030;South Holland;65701;49497;13074;36423;0,2744250468029406;0,7533675286525319;0,2641372204376023;0,7358627795623978
18173;Surrey Heath;65569;52305;25638;26667;0,27715841327456575;0,7977092833503637;0,4901634642959564;0,5098365357040436
19840;Selby;65278;51603;21071;30532;0,30393088023530135;0,7905113514507185;0,40832897312171773;0,5916710268782823
37531;Watford;65060;46586;23167;23419;0,5768675069166923;0,7160467260989856;0,49729532477568367;0,5027046752243163
20279;Uttlesford;64735;51943;25619;26324;0,31326175948096086;0,8023943770757704;0,493213715033787;0,5067862849662129
30739;Pendle;64534;45335;16704;28631;0,4763225586512536;0,702497908079462;0,36845704202051394;0,631542957979486
46197;Burnley;64461;43316;14462;28854;0,7166658910038628;0,6719722002451094;0,33387201034259856;0,6661279896574014
20588;Tandridge;64044;51420;24251;27169;0,3214664917868965;0,8028855162076073;0,4716258265266433;0,5283741734733567
43784;Lincoln;63351;43894;18902;24992;0,6911335259111931;0,6928698836640306;0,4306283318904634;0,5693716681095367
26855;Gosport;62781;46127;16671;29456;0,4277568054029085;0,7347286599448878;0,36141522318815444;0,6385847768118456
13552;East Cambridgeshire;62435;48086;23599;24487;0,21705774004965164;0,7701769840634259;0,4907665432766294;0,5092334567233706
33894;Stevenage;62156;45785;18659;27126;0,5453053607053221;0,7366143252461549;0,4075352189581741;0,5924647810418259
36117;Hyndburn;62042;40137;13569;26568;0,582137906579414;0,6469327229941008;0,3380671201136109;0,6619328798863892
36776;Hastings;61957;44350;20011;24339;0,5935729618929257;0,7158190357828816;0,45120631341600903;0,548793686583991
19022;Fylde;61174;46206;19889;26317;0,3109490960211855;0,7553208879589368;0,43044193394797214;0,5695580660520279
28903;Redditch;61038;45882;17303;28579;0,4735246895376651;0,7516956649955765;0,37711956758641735;0,6228804324135827
22449;Daventry;61004;49381;20443;28938;0,3679922628024392;0,8094715100649138;0,4139851359834754;0,5860148640165246
11602;Mid Devon;60532;48006;22400;25606;0,19166721733958897;0,7930681292539483;0,4666083406240887;0,5333916593759114
17487;Malvern Hills;60217;48497;23203;25294;0,2903997210090174;0,805370576415298;0,478441965482401;0,5215580345175991
34288;Harlow;59124;43469;13867;29602;0,5799336986672079;0,7352175089642108;0,31900894890611703;0,680991051093883
19503;Brentwood;58777;46704;19077;27627;0,33181346445038024;0,7945965258519488;0,4084660842754368;0,5915339157245632
23211;Runnymede;58272;44294;20259;24035;0,39832166392092255;0,7601249313563976;0,4573757168013726;0,5426242831986273
19384;Bolsover;58063;41972;12242;29730;0,33384427260045124;0,7228699860496357;0,2916706375679024;0,7083293624320975
10725;Derbyshire Dales;57075;46728;22633;24095;0,18791064388961892;0,8187122207621551;0,4843562746105119;0,5156437253894881
22204;Tamworth;56825;42129;13705;28424;0,39074351077870656;0,7413814342278926;0,3253103562866434;0,6746896437133566
20099;Epsom and Ewell;56382;45303;23596;21707;0,3564790181263524;0,8035011173778865;0,5208485089287685;0,4791514910712315
29203;Wellingborough;54572;41141;15462;25679;0,535127904419849;0,7538847760756432;0,3758294645244403;0,6241705354755597
15624;Copeland;54206;37947;14419;23528;0,2882337748588717;0,7000516547983618;0,3799773368118692;0,6200226631881308
15725;Ceredigion;53400;39742;21711;18031;0,29447565543071164;0,7442322097378277;0,5462986261385939;0,4537013738614061
21696;Barrow-in-Furness;53194;36074;14207;21867;0,4078655487460992;0,6781591908861901;0,39382935077895437;0,6061706492210456
11367;North Dorset;52980;42201;18399;23802;0,21455266138165346;0,796545866364666;0,435984929267079;0,564015070732921
10424;Torridge;52881;41429;16229;25200;0,19712183960212554;0,7834382859628222;0,3917304303748582;0,6082695696251418
20768;Rossendale;52750;38181;15012;23169;0,3937061611374408;0,7238104265402844;0,39317985385401116;0,6068201461459889
15332;South Bucks;52194;40724;20077;20647;0,2937502394911293;0,7802429398015097;0,49300166977703563;0,5069983302229644
14410;Isle of Anglesey;51445;37951;18618;19333;0,2801049664690446;0,7377004567985227;0,49057995836736845;0,5094200416326315
24788;Blaenau Gwent;51136;34802;13215;21587;0,4847465581977472;0,6805772841051314;0,37971955634733634;0,6202804436526637
25197;Weymouth and Portland;50442;38255;14903;23352;0,4995242060187939;0,7583957812933666;0,3895699908508692;0,6104300091491308
17917;North Warwickshire;49790;37954;12569;25385;0,35985137577826876;0,7622815826471179;0,33116404068082417;0,6688359593191758
10807;Maldon;49073;38831;14529;24302;0,22022293318117905;0,7912905263586901;0,3741598207617625;0,6258401792382375
13708;Adur;48755;37229;16914;20315;0,28116090657368475;0,7635934775920419;0,45432324263343093;0,5456767573665691
11293;Ribble Valley;46148;36442;15892;20550;0,24471266360405652;0,7896766923810349;0,43609022556390975;0,5639097744360902
10001;Craven;44320;35891;16930;18961;0,22565433212996389;0,8098149819494584;0,4717059987183416;0,5282940012816584
8107;West Devon;43823;35595;16658;18937;0,1849941811377587;0,8122447116810807;0,4679870768366344;0,5320129231633657
23790;Corby;43313;32081;11470;20611;0,5492577286265093;0,7406783182878119;0,3575324958698295;0,6424675041301705
21039;Merthyr Tydfil;42855;28865;12574;16291;0,4909345467273364;0,6735503441838758;0,43561406547722153;0,5643859345227784
11375;Oadby and Wigston;42684;31465;14292;17173;0,2664932995970387;0,7371614656545779;0,45421897346257745;0,5457810265374226
8065;Eden;41872;31718;14807;16911;0,19261081390905618;0,7574990447076806;0,46683271328583137;0,5331672867141686
8223;Ryedale;41529;32050;14340;17710;0,19800621252618653;0,7717498615425366;0,4474258970358814;0,5525741029641186
18792;Boston;39363;30404;7430;22974;0,47740263699413155;0,7724004776058735;0,24437574003420603;0,755624259965794
10941;Christchurch;39176;31050;12782;18268;0,27927812946702063;0,7925770880130693;0,411658615136876;0,588341384863124
14876;Forest Heath;38527;27951;9791;18160;0,38611882575855894;0,7254912139538505;0,3502915816965404;0,6497084183034596
8940;Melton;37273;30305;12695;17610;0,23985190352265714;0,8130550264266359;0,41890777099488535;0,5810922290051147
8330;Richmondshire;36794;27636;11945;15691;0,22639560797956187;0,7511007229439582;0,4322260819221306;0,5677739180778695
8640;Purbeck;36418;28720;11754;16966;0,2372453182492174;0,7886210115876764;0,40926183844011144;0,5907381615598886
4351;Rutland;29390;22966;11353;11613;0,1480435522286492;0,7814222524668254;0,4943394583297048;0,5056605416702952
5499;West Somerset;27478;21734;8566;13168;0,2001237353519179;0,7909600407598806;0,3941290144474096;0,6058709855525904
25255;City of London;5987;4399;3312;1087;4,218306330382496;0,7347586437280775;0,7528983859968175;0,24710161400318253
269;Isles of Scilly;1799;1424;803;621;0,14952751528627015;0,7915508615897721;0,5639044943820225;0,43609550561797755
